####################
#                  #
#  ###  ####  ###  #
#                  #
#    #####         #
#                  #
######    #####    #
#         #        #
#  ##     #        #
#      ####        #
#         #        #
#   #     #        #
#   #              #
#   #      ####### #
#   #####          #
#   #      #       #
#   #      #       #
#   #    #######   #
#                  #
####################