############################################################
############################################################
##                                                        ##
##                                                        ##
##                                                        ##
##                                                        ##
##    #####    ##########    #####    ##########    ##    ##
##    #####    ##########    #####    ##########    ##    ##
##    #####    ##########    #####    ##########    ##    ##
##    #####    ##########    #####    ##########    ##    ##
##                                                        ##
##                                                        ##
##                                                        ##
##                                                        ##
##    #####    ##########    #####    ##########    ##    ##
##    #####    ##########    #####    ##########    ##    ##
##    #####    ##########    #####    ##########    ##    ##
##    #####    ##########    #####    ##########    ##    ##
##                                                        ##
##                                                        ##
##                                                        ##
##                                                        ##
##    #####    ##########    #####    ##########    ##    ##
##    #####    ##########    #####    ##########    ##    ##
##                                                        ##
##                                                        ##
##                                                        ##
##                                                        ##
############################################################
############################################################